F 220,100,0  
C 225,30,0

NO ./textures/quake/north.xpm
SO ./textures/quake/south.xpm
WE ./textures/quake/west.xpm
EA ./textures/quake/east.xpm

11111 11111 11111
10001 10001 10001
10N01 10001 10W01
10001 10001 10001
11111 11111 11111