F 220,100,0  
C 225,30,0

NO ./textures/quake/north.xpm
SO ./textures/quake/south.xpm
WE ./textures/quake/west.xpm
EA ./textures/quake/east.xpm


111111111111111111111						
101010001000000000001
101010101011111110001
100010100010000010001
111110101111101011101					
100000101000101000001
101111101011101111111
101000001010100000101
101011111010111110101		
101010001010100010101
101110101010101010101
100000101010001010001
111111101011111011101
100000101000100010001
100000101110101110111
100000000000100010101	
100000111111111010101
100000000000000010001
100010000011111111101
1NW010001000000000001
111111111111111111111